#########
#S  #   #
# # # # #
# #     #
# ##### #
#  #    #
###  ## #
#     #E#
#########